10 80
--------------------------------------------------------------------------------
=====---------------------------------------------------------------------------
--------------------------------------------------------------------------------
------=-------------------------------------------------------------------------
--------------------------------------------------------------------------------
-S----------=-------------------------------------------------------------------
------------=-----------------------=---===--===--===-=-------------------------
--==------========-----======------==-----------------==------------------------
======---------------------------====-----------------=========================-
--------------------------------------------------------------------------------