10 33
------------------------------F--
=====--------======------======--
---------------------------------
------=--------------------------
---------------------------------
------------=--------------------
S-----------=--------------------
--==------========-----======----
======---------------------------
---------------------------------