10 33
-------------E---E-------E----F--
=====--------======------======--
---------------------------------
------=--------------------------
--E------------------------------
------------=--------------------
S-----------=--------------------
--==------========-----======----
======---------------------------
---------------------------------